DEPTH FIRST SEARCH 
 F - Free 
 O - Occupied 
 S - Starting point 
 G - Goal 
 E - Path/visited 
 (Abdulaziz Albastaki 2020) 
 
 (top left coordinate - 0,0) 
 Final Solution  

OOOOOOOOOOOOOOOOOOOOOOOOOOOOOOO
OOFFFFFFFOOFOOOOOOOOFFFFEEEGOOO
OOFOOOFOFOOOOOOOOOOOOOOOEOOOFOO
OOFOOOOOOOOOOOFOFOOOOOOOEOOOFOO
OOFFFEEEOOOOOOFOFOOOOOOOEOOOFOO
OOFOOEOEOOOOOOFOFOOOOFOOEOOOFFO
OEEOOEFEEEOOEEEEEEEEEEEEEOOOOFO
OEEEEEFEEEOOEOOOOFOEEEOOOFOOOFO
OEOOOOOFOEOOEOOOFOOOOEEFFFOOOFO
OEFFFOOOOEEEEEEEEEEEEEEOOFFFFFO
OOOOOOOOOOOOOOOOOOOOOOOOOOOOOOO
 
 All spots visited 

OOOOOOOOOOOOOOOOOOOOOOOOOOOOOOO
OOFFFFFFFOOFOOOOOOOOFFFFEEEGOOO
OOFOOOFOFOOOOOOOOOOOOOOOEOOOEOO
OOFOOOOOOOOOOOEOEOOOOOOOEOOOEOO
OOFFFEEEOOOOOOEOEOOOOOOOEOOOEOO
OOFOOEOEOOOOOOEOEOOOOEOOEOOOEEO
OEEOOEFEEEOOEEEEEEEEEEEEEOOOOEO
OEEEEEFEEEOOEOOOOEOEEEOOOEOOOEO
OEOOOOOEOEOOEOOOEOOOOEEEEEOOOEO
OEEEEOOOOEEEEEEEEEEEEEEOOEEEEEO
OOOOOOOOOOOOOOOOOOOOOOOOOOOOOOO
 
 Original problem 

OOOOOOOOOOOOOOOOOOOOOOOOOOOOOOO
OOFFFFFFFOOFOOOOOOOOFFFFFFFGOOO
OOFOOOFOFOOOOOOOOOOOOOOOFOOOFOO
OOFOOOOOOOOOOOFOFOOOOOOOFOOOFOO
OOFFFFFFOOOOOOFOFOOOOOOOFOOOFOO
OOFOOFOFOOOOOOFOFOOOOFOOFOOOFFO
OFFOOFFFFFOOFFFFFFFFFFFFFOOOOFO
OFFFFFFFFFOOFOOOOFOFFFOOOFOOOFO
OSOOOOOFOFOOFOOOFOOOOFFFFFOOOFO
OFFFFOOOOFFFFFFFFFFFFFFOOFFFFFO
OOOOOOOOOOOOOOOOOOOOOOOOOOOOOOO