GREEDY BEST SEARCH 
 F - Free 
 O - Occupied 
 S - Starting point 
 G - Goal 
 E - Path/visited 
 (Abdulaziz Albastaki 2020) 
 
 (top left coordinate - 0,0) 
 Final Solution  

OOOOOOOOOOOOOOOO
OFFFFFFFFFFFFOGO
OFOOOOOOOOOOOOEO
OFOOOOOOOOOOOOEO
OFOOOOOOOOOOOOEO
OFOOOOOOOOOOOOEO
OSEEEEEEEEEEEEEO
OOOOOOOOOOOOOOOO
 
 All spots visited 

OOOOOOOOOOOOOOOO
OFFFFFFFFFFFFOGO
OFOOOOOOOOOOOOEO
OFOOOOOOOOOOOOEO
OFOOOOOOOOOOOOEO
OFOOOOOOOOOOOOEO
OEEEEEEEEEEEEEEO
OOOOOOOOOOOOOOOO
 
 Original problem 

OOOOOOOOOOOOOOOO
OFFFFFFFFFFFFOGO
OFOOOOOOOOOOOOFO
OFOOOOOOOOOOOOFO
OFOOOOOOOOOOOOFO
OFOOOOOOOOOOOOFO
OSFFFFFFFFFFFFFO
OOOOOOOOOOOOOOOO